11111111111111111111111111111111
1P000000001000000000000000000001
11111111101011111111111111111101
10000000001010000000000000000001
10111111111010111111111111111111
10001001111010111111111100010001
10101010000011100010000101010101
10101010111111111011110101010101
10101010100000001000000001110101
10101010100000011111011111110101
10101010111111000000000000000101
10100010001000011111111111111101
10111111101011000000000000010101
10100111101011111111111111010101
10100001101000000000000001010101
101010111011111111111111011101C1
100010000000000000000000000001E1
11111111111111111111111111111111