11111111111111111111111111
100P00E0111111111000000E01
10000000111111111000000001
100C00000001110000000C0001
111111110001C1000111111111
11111111000111000111111111
10000000000000000000000001
100C00E0111111111000C00001
10000000111111111000000001
11111111111111111111111111
