1111111
1EC0001
1010011
1010011
1P00001
1000001
1111111
