1111111111111111111111
100P011100100100111101
1C00000000P01111111111
1E11111111111110111111
1111111111111111111111